-1 -1 -1 -1 -1 -1 -1 S -1 -1 -1 -1 -1 -1 -1
-1 1 1 1 1 1 1 1 1 1 1 1 -1 -1 -1
-1 1 -1 2 -1 -1 -1 -1 -1 -1 4 -1 -1 -1 -1
-1 -1 -1 2 -1 1 -1 -1 -1 -1 4 1 1 -1 -1
-1 -1 -1 2 -1 B 3 3 -1 -1 -1 -1 2 1 -1
-1 -1 1 2 -1 1 -1 1 -1 -1 -1 -1 1 -1 -1
-1 -1 -1 2 -1 1 -1 1 -1 -1 -1 -1 1 -1 -1
-1 -1 -1 2 1 2 1 1 1 1 -1 -1 1 1 -1
-1 -1 -1 -1 -1 1 -1 1 -1 -1 -1 -1 -1 1 -1
-1 -1 -1 -1 -1 -1 -1 1 -1 -1 -1 -1 -1 1 -1
-1 -1 -1 -1 -1 -1 -1 1 1 1 1 1 2 A -1
-1 -1 -1 -1 -1 -1 -1 1 -1 -1 -1 2 -1 1 -1
-1 -1 -1 -1 -1 -1 1 1 1 1 1 1 -1 1 -1
-1 -1 -1 -1 -1 -1 -1 1 -1 -1 -1 -1 -1 -1 -1
-1 -1 -1 -1 -1 -1 -1 G -1 -1 -1 -1 -1 -1 -1